5,5,5,5,5,5,5,1,0,0,5,5,5,5,5,5
5,5,5,5,2,2,2,2,2,2,2,2,2,5,5,5
5,5,4,3,3,3,3,3,3,3,3,3,3,3,5,5
5,5,3,5,4,3,3,3,3,3,3,3,3,5,2,5
5,2,3,4,3,3,3,3,3,3,3,3,3,4,2,5
5,2,3,3,4,3,3,4,3,3,3,3,3,3,2,5
5,2,4,3,4,3,3,3,3,3,3,3,3,4,2,5
0,2,4,3,4,3,3,3,3,3,4,3,3,3,2,0
0,2,3,3,3,3,3,3,3,3,3,3,3,3,2,0
0,2,3,4,3,3,3,3,3,3,3,3,3,3,2,0
5,2,3,3,3,3,3,4,3,3,3,3,3,3,2,5
5,2,3,3,3,3,3,4,3,3,3,3,3,3,2,5
5,2,3,5,3,3,3,3,3,3,3,3,3,5,2,5
5,5,3,3,4,3,3,3,3,3,3,3,5,5,5,5
5,5,5,5,2,2,2,2,2,2,2,2,2,5,5,5
5,5,5,5,5,5,5,0,0,0,5,5,5,5,5,5
