5,5,5,5,5,5,5,0,0,0,5,5,5,5,5,5
5,2,2,2,2,2,2,2,2,2,2,2,2,2,2,5
5,2,3,3,3,3,3,3,3,3,3,3,3,3,2,5
5,2,3,3,3,3,3,3,3,3,3,3,4,3,2,5
5,2,3,3,4,3,3,3,3,3,4,3,3,3,2,5
5,2,3,3,3,4,3,3,3,3,3,3,3,3,2,5
5,2,4,3,3,3,3,3,3,3,3,3,3,3,2,5
0,2,3,3,3,3,3,3,3,4,3,3,3,3,2,0
0,2,3,3,3,3,3,3,3,3,3,3,3,3,2,0
0,2,4,3,3,3,3,3,3,3,3,3,3,3,2,0
5,2,3,3,3,3,3,3,3,3,3,3,3,3,2,5
5,2,3,3,3,3,3,3,3,3,3,3,3,4,2,5
5,2,4,3,3,3,3,3,3,3,3,4,3,3,2,5
5,2,3,3,3,3,3,3,3,3,3,3,3,3,2,5
5,2,2,2,2,2,2,2,2,2,2,2,2,2,2,5
5,5,5,5,5,5,5,0,0,0,5,5,5,5,5,5
