0,1,0,0,0,1,0,1,0,1,1,0,0,0,0,1
0,2,2,2,2,2,2,2,2,2,2,2,2,2,2,0
1,2,3,3,3,3,3,3,3,3,3,3,3,3,2,1
1,2,3,4,3,3,3,3,3,3,3,3,3,3,2,1
1,2,3,3,3,3,3,3,7,3,3,3,3,3,2,0
1,2,4,3,3,3,3,3,3,3,4,3,3,3,2,0
0,2,3,3,3,5,3,3,3,3,5,3,3,3,2,1
0,2,3,3,3,3,4,3,4,3,3,3,3,3,2,0
8,9,8,9,8,9,8,9,8,9,8,9,8,9,8,9
0,2,4,3,3,3,3,3,3,3,3,3,4,3,2,1
1,2,3,4,3,3,4,3,3,3,3,3,3,4,2,1
1,2,3,3,3,3,3,4,3,3,3,3,3,3,2,0
1,2,3,3,3,3,3,7,7,7,3,3,3,3,2,1
0,2,3,3,3,3,3,3,3,3,3,3,3,3,2,0
1,2,2,2,2,2,2,2,2,2,2,2,2,2,2,1
1,1,0,1,0,1,0,0,1,0,1,1,1,1,0,1
